1111111111111111111111111111
1E00000000000C00001C00010001
1010010100100010100100010101
1010010010101000100100010101
1P0000000C0000000010000100C1
1111111111111111111111111111
