1111111111111
A0010000000C1
1000011111001
1P0011E000001
11111B1111111
